Abram		Abakumov
Afanas		Abdulov
Afanas		Abramov
Afanasy		Abramovich
Afon		Afanasyev
Afonasei		Aksyonov
Akim		Alexandrov
Albert		Alexeyev
Aleks		Andreyev
Alexander		Anisimov
Alexei		Artyomov
Anatoly		Avdeyev
Andrei		Averyanov
Anton		Balabanov
Arkady		Balandin
Arseny		Bazhenov
Artur		Bazin
Artyom		Belinsky
Bogatyr		Bezrukov
Bogdan		Blokhin
Boleslav		Bobkov
Boris		Bobrov
Daniil		Bogdanov
David		Bogolyubov
Denis		Bogomazov
Dmitry		Bychkov
Dobrushin		Chkalov
Dorofey		Davydov
Eduard		Dementyev
Erik		Demidov
Evgeniy		Denisov
Evgeny		Dmitriyev
Faddei		Dostoyevsky
Fanasiy		Dubinin
Fedir		Engalychev
Filipp		Essen
Florentiy		Fokin
Foma		Fomin
Foma		Frolov
Garry		Gagarin
Gavriil		Garin
Gavril		Gerasimov
Gedeon		Glazkov
Gennady		Ibragimov
Georgy		Ignatyev
Gerasim		Ilyin
German		Isayev
Gleb		Istomin
Goga		Ivankov
Grigory		Ivanov
Iakov		Ivashov
Ignat		Izmaylov
Igor		Kalashnik
Ilariy		Kalinin
Ilia		Kapitsa
Illarion		Kapustin
Ilya		Kazakov
Immanuil		Kazantsev
Innokentiy		Khabarov
Ioakim		Kirillov
Ioann		Kirilov
Iosif		Knyazev
Ipatiy		Kolesov
Ippolit		Koltsov
Irinei		Komarov
Isai		Korotkov
Isidor		Koshkin
Ivan		Kostin
Julij		Kotov
Kazimir		Kovalevsky
Khariton		Kozlovsky
Kir		Kravchuk
Kirill		Kruglov
Kliment		Krylov
Koldan		Krymov
Kolmogor		Kryukov
Kolodka		Kudryashov
Kolya		Kudryavtsev
Kolzak		Kutepov
Konstantin		Kutuzov
Kostya		Kuzmin
Kuzma		Kuznetsov
Lavrentii		Kvasov
Lazar		Lapidus
Leonid		Lapin
Leontiy		Larionov
Ludmil		Lavrentyev
Makar		Lavrov
Makariy		Lebedev
Maksim		Lobanov
Marat		Loginov
Mark		Loginovsky
Marlen		Loktionov
Matvei		Lomonosov
Matvey		Losev
Maxim		Lukin
Mefodiy		Lukyanenko
Melor		Lytkin
Mikhail		Makarov
Mikhail		Maksimov
Miron		Malakhov
Misha		Markov
Mitrofan		Matveyev
Mitya		Myasnikov
Modest		Myshkin
Modya		Naumov
Motya		Nazarov
Naum		Nekrasov
Nazar		Nesterov
Nazariy		Nikiforov
Nestor		Nikitin
Nikita		Nikolayev
Nikolay		Nikonov
Oleg		Noskov
Onisim		Nosov
Osip		Novikov
Pankratiy		Obolensky
Pasha		Orlov
Patya		Ostrovsky
Pavel		Ozerov
Petya		Pavlov
Pyotr		Pestov
Pyotr		Petrov
Robert		Polivanov
Rodion		Polunin
Rodya		Ponomaryov
Rolan		Popov
Roman		Preobrazhensky
Rostislav		Primakov
Rostya		Pugin
Rurik		Putin
Ruslan		Rabinovich
Samuil		Sakharov
Sasha		Samoylov
Sashura		Samsonov
Saveliy		Sapozhnikov
Savin		Sedov
Savva		Seleznyov
Semyon		Semyonov
Sergei		Sergeyev
Spartak		Severny
Stanislav		Shalyapin
Stas		Shaposhnikov
Stefan		Sharapov
Stepan		Sharov
Taras		Sidorov
Timofei		Solomin
Timur		Sorokin
Timur		Stalin
Tit		Stepanov
Trofim		Sukhanov
Vadim		Sychyov
Valentin		Syomin
Valeriy		Sysoyev
Valery		Tamarkin
Vanja		Tarasov
Vanya		Tereshchenko
Varfolomei		Timofeyev
Varnava		Titov
Vasiliy		Tsereteli
Vasily		Tsulukidze
Vasya		Tsvetkov
Venedikt		Turov
Veniamin		Ukhtomsky
Vikentiy		Ulanov
Viktor		Ulyanov
Vitaliy		Uspensky
Vitaly		Ustinov
Vitya		Uvarov
Vlad		Vasilyev
Vladimir		Vavilov
Vladimir		Vereshchagin
Vladislav		Vinogradov
Vlasii		Volkov
Vlasiy		Volodin
Volya		Voloshin
Vsevolod		Vorobyov
Vyacheslav		Voronin
Yakim		Voronov
Yakov		Yablonsky
Yaromir		Yakimov
Yaropolk		Yakovlev
Yaroslav		Yakubovich
Yasha		Yakushev
Yefim		Yashin
Yefrem		Yegorov
Yegor		Yeltsin
Yemelyan		Yevdokimov
Yermolai		Yevseyev
Yevgeniy		Yusupov
Yuli		Zaporozhets
Yulian		Zarubin
Yuliy		Zaytsev
Yuri		Zhdanov
Zakhar		Zimin
Zinoviy		Zubarev